designations	domain
Software Test Engineer	Quality Assurance
Software QA Manager	Quality Assurance
Director Software Quality Assurance	Quality Assurance
Systems Test Analyst	Quality Assurance
Software Test Technician	Quality Assurance
Software Testing Jobs	Quality Assurance
Vice President Quality	Quality Assurance
Security Officer	Quality Assurance
Chief Quality Officer	Quality Assurance
Vice President Quality Assurance	Quality Assurance
Global Safety Officer	Quality Assurance
Quality Assurance Manager	Quality Assurance
Quality Manager	Quality Assurance
Director of Quality	Quality Assurance
Director Quality Assurance	Quality Assurance
Quality Systems Manager	Quality Assurance
Supplier Quality Manager	Quality Assurance
Process Control Supervisor	Quality Assurance
Director Quality Systems	Quality Assurance
Clinical Quality Manager	Quality Assurance
Quality Control Systems Manager	Quality Assurance
Director Supplier Quality	Quality Assurance
Quality Assurance Group Leader	Quality Assurance
QA Analyst	Quality Assurance
Quality Inspector	Quality Assurance
Quality Analyst	Quality Assurance
Quality Assurance Technician	Quality Assurance
Quality Assurance Coordinator	Quality Assurance
Quality Coordinator	Quality Assurance
QC Lab Technician	Quality Assurance
Clinical Quality Analyst	Quality Assurance
Quality Assurance Analyst	Quality Assurance
Functional Tester	Quality Assurance
Quality Assurance	Quality Assurance
QA Analyst	Quality Assurance
Quality Assurance Assistant	Quality Assurance
Quality Systems Engineer	Quality Assurance
Quality Systems Specialist	Quality Assurance
Process Control Technician	Quality Assurance
Quality Assistant	Quality Assurance
Supplier Quality Specialist	Quality Assurance
Quality Assurance Supervisor	Quality Assurance
Quality Review Specialist	Quality Assurance
Quality Controller	Quality Assurance
Production Quality Analyst	Quality Assurance
Quality Audit Representative	Quality Assurance
Quality Review Trainer	Quality Assurance
Quality Assurance Jobs	Quality Assurance
Quality Jobs	Quality Assurance
QA Automation Enginneer	Quality Assurance
Quality Assurance Engineer	Quality Assurance
Middle QA Engineer	Quality Assurance
Mid-level QA Engineer	Quality Assurance
QA Engineer	Quality Assurance
QA Developer	Quality Assurance
Entry-level QA Engineer	Quality Assurance
Quality Analyst	Quality Assurance
QA Developer	Quality Assurance
Senior Quality Analyst	Quality Assurance
QA Tester	Quality Assurance
Quality Assurance	Quality Assurance
Automation Engineer	Quality Assurance
QA Engineer	Quality Assurance
Quality Assurance Engineer	Quality Assurance
Quality Assurance Specialist	Quality Assurance
Information Assurance Analyst	Quality Assurance
Quality Assurance Associate	Quality Assurance
Quality Assurance Engineer	Quality Assurance
Quality Assurance Technician	Quality Assurance
Quality Assurance	Quality Assurance
Quality Assurance Specialist	Quality Assurance
Quality Assurance Manager	Quality Assurance
Computer Systems Analyst	Quality Assurance
Quality Assurance	Quality Assurance
QA Automation Engineer	Quality Assurance
Test Man	Quality Assurance
Product Manager	Quality Assurance
Automation Engineer	Quality Assurance
QA Engineer	Quality Assurance
Quality Assurance Engineer	Quality Assurance
Technical Lead	Quality Assurance
Quality Assurance	Quality Assurance
QA Automation Engineer	Quality Assurance
Data Science Intern	Data Science
Machine Learning Intern	Data Science
ML Intern	Data Science
Artificlal Intelligence Intern	Data Science
AI Intern	Data Science
Data Analyst	Data Science
Data Engineers	Data Science
Database Administrator	Data Science
Machine Learning Engineer	Data Science
Data Scientist	Data Science
Data Architect	Data Science
Statistician	Data Science
Business Analyst	Data Science
Data and Analytics Manager	Data Science
Data Engineer	Data Science
AI Product Manager	Data Science
AI Architect	Data Science
Data Analyst	Data Science
Data Engineer	Data Science
Statistician	Data Science
Statics Expert	Data Science
Data Scientist	Data Science
Lead Data Scientist	Data Science
Principal Data Scientist	Data Science
Chief Data Scientist	Data Science
Associate Data Scientist	Data Science
Head of Data Science	Data Science
Data Scientist I    Data Science
Data Scientist  Data Science
Data Scientist  Data Science
Data Scientist II	Data Science
Senior Data Scientist	Data Science
Director of Data Science	Data Science
Manager of Data Science	Data Science
Sr. Manager of Data Science	Data Science
Sr. Director of Data Science	Data Science
VP of Data Science	Data Science
Data Science Specialist	Data Science
AI Developer	Data Science
Machine Learning Engineer	Data Science
Natural Language Processing Expert	Data Science
NLP Expert	Data Science
Computer Vision Expert	Data Science
CV Expert	Data Science
Artificial Intelligence Specialist 	Data Science
Artificial Intelligence Product Manager	Data Science
Artificial Intelligence Engineer	Data Science
Artificial Intelligence Ethicist	Data Science
Algorithm Engineer	Data Science
Machine Learning Engineer	Data Science
Artificial Intelligence Developer	Data Science
Artificial Intelligence Engineer	Data Science
Applied Machine Learning Engineer	Data Science
Intelligence Designer	Data Science
Data Curator	Data Science
Data Evangelist	Data Science
Machine Learning Data Scientist	Data Science
Robotics Process Analyst	Data Science
Digital Knowledge Manager	Data Science
AI Interaction Designer	Data Science
Data Scientist	Data Science
Senior Data Scientist	Data Science
Cognitive Copywriter	Data Science
AI Researcher	Data Science
Research Assistant	Data Science
PYTHON SOFTWARE ENGINEER-DEEP LEARNING	Data Science
Machine Learning Engineer	Data Science
Entry-Level Django Developer	Python
Junior Python Developer	Python
Python Full Stack Developer	Python
GIS Analyst	Python
Senior Python Developer	Python
Data Scientist	Python
Intern Python Developer	Python
Mid-level Python Developer	Python
PYTHON SOFTWARE ENGINEER-DEEP LEARNING	Python
Python Developer	Python
Senior-level Python Developer	Python
Entry-level Python Developer	Python
Django Developer	Python
Django Web Developer	Python
Flask Developer	Python
Junior Python Developer	Python
Senior Python Developer	Python
Oddo Specialist	Python
Django Expert	Python
Senior Python Developer	Python
Django Developer	Python
API Developer	Python
NinJava	Java
Java Hacker	Java
JavaX	Java
DeCoder	Java
Software Engineer (Java)	Java
Senior Software Engineer (Java)	Java
Lead Developer	Java
Lead Java Developer	Java
Lead Web Developer	Java
Java Developer	Java
Java Developer	Java
Java Developer Fresher	Java
Java Developer Intern	Java
Java Spring Boot Developer	Java
Senior Java Developer	Java
Java Programmer	Java
Java Application Developer	Java
Java Developer	Java
Jr. Java Developer	Java
Junior Java Developer	Java
Java Web Developer	Java
Java Kafka Sr. Developer	Java
Applications Developer - Java	Java
Java J2EE Developer	Java
Full Stack Java Developer	Java
Senior Java Developer	Java
Senior Java Developer	Java
Java Engineer	Java
Fresher Java Developer	Java
Entry-level Java Developer	Java
Mid-level Java Developer	Java
Senior-level Java Developer	Java
Senior Java Developer	Java
UX Designer	UI/UX
UI Designer	UI/UX
UX Engineer	UI/UX
UI/UX Developer	UI/UX
Graphic Artist	UI/UX
UX Researcher	UI/UX
Lead UX Designer	UI/UX
Sr. UI/UX Designer	UI/UX
UX Manager	UI/UX
Interaction Designer	UI/UX
Frontend Developer	UI/UX
Front-end Developer	UI/UX
Frontend Designer	UI/UX
Front-end Designer	UI/UX
Graphic Designer	UI/UX
User Experience Designer	UI/UX
Front End Developer	UI/UX
Front-End Engineer	UI/UX
CSS/HTML Developer	UI/UX
HTML/CSS Developer	UI/UX
HTML Developer	UI/UX
CSS Developer	UI/UX
Front-End Web Designer	UI/UX
Mobile/Tablet Front-End Developer	UI/UX
Front-End Accessibility Expert	UI/UX
Front-End Dev. Ops	UI/UX
Front-End Testing/QA	UI/UX
Interaction Designer	UI/UX
Art Director	UI/UX
Security Analyst	Cyber Security
Security Engineer	Cyber Security
Security Architect	Cyber Security
Security Administrator	Cyber Security
Security Software Developer	Cyber Security
Cryptographer	Cyber Security
Cryptanalyst	Cyber Security
Security Consultant	Cyber Security
Information Security Specialist	Cyber Security
Chief Information Security Officer	Cyber Security
Information Security	Cyber Security
CISO	Cyber Security
Information Security Architect	Cyber Security
Chief Information Security Officer	Cyber Security
Forensic Computer Analyst	Cyber Security
Information Security Analyst	Cyber Security
Penetration Tester	Cyber Security
Malware Analyst	Cyber Security
Security Architect	Cyber Security
Cyber Security	Cyber Security
IT Security Engineer	Cyber Security
Security Systems Administrator	Cyber Security
IT Security Consultant	Cyber Security
Cyber Security Specialist	Cyber Security
Network Administrator	IT & Networking
Network Engineer	IT & Networking
Network Professional	IT & Networking
Cisco Certified Network Professional	IT & Networking
Cisco Certified Network Associate	IT & Networking
IT Director	IT & Networking
Network Support	IT & Networking
Networking Technician	IT & Networking
Cisco Certified Network Professional	IT & Networking
Support Manager	IT & Networking
Network Support Engineer	IT & Networking
Technician	IT & Networking
Computer Engineer	IT & Networking
Product Engineer	IT & Networking
CISSP	IT & Networking
Chief Technology Officer	Project Management
Director Engineering	Project Management
Consulting Manager	Project Management
Supply Chain Tech	Project Management
Platform Engineer	Project Management
Team Lead	Project Management
Incident Coordinator	Project Management
Project Manager	Project Management
Project Coordinator	Project Management
Scrum Master	Project Management
Product Manager	Project Management
Human Resources Assistant	HR
HR Assistant	HR
HR Business Partner	HR
HR Generalist	HR
Generalist	HR
Human Resources Generalist	HR
Public Relations	Marketing and Business
Public Relations Specialist	Marketing and Business
Business Analyst	Marketing and Business
Marketing Manager	Marketing and Business
Director of Marketing	Marketing and Business
Senior Marketing Manager	Marketing and Business
Application DBA	Marketing and Business
Communications Manager	Marketing and Business
Marketing Manager	Marketing and Business
Technical Communicator	Marketing and Business
Senior PHP Developer	Web Development
Software Engineer	Web Development
PHP Developer	Web Development
Senior Software Developer	Web Development
Net Developer	Web Development
Net Developer	Web Development
Senior Web Developer	Web Development
.Net Developer	Web Development
Senior Web Developer	Web Development
Web Developer	Web Development
Senior iOS Developer	Android/Ios
Android Developer   Android/Ios
iOS Developer	Android/Ios
Senior Android Developer	Android/Ios
Mobile Developer	Android/Ios
Android Developer	Android/Ios
Senior Database Administrator	Database
SQL Server DBA	Database
Database Engineer	Database
Database Administrator	Database
Database Support	Database
Search Strategist	Digital Marketing and SEO
Content Strategist	Digital Marketing and SEO
Search Engine Optimization Specialist	Digital Marketing and SEO
Digital Strategist	Digital Marketing and SEO
SEO Strategist	Digital Marketing and SEO
Associate	Digital Marketing and SEO
CRO	Digital Marketing and SEO
SEO Specialist	Digital Marketing and SEO
Search Engine Marketing Specialist	Digital Marketing and SEO
SEO Manager	Digital Marketing and SEO
Search Manager	Digital Marketing and SEO
Search Strategist	Digital Marketing and SEO
Content Strategist	Digital Marketing and SEO
Search Engine Optimization Specialist	Digital Marketing and SEO
Associate	Digital Marketing and SEO
CRO	Digital Marketing and SEO
Digital Marketing Coordinator	Digital Marketing and SEO
SEO Specialist	Digital Marketing and SEO
Search Manager	Digital Marketing and SEO
